# Syntax Colouring Map For AverageAngle

# Data types (KEYWORD1)
AverageAngle	KEYWORD1
AngleType	KEYWORD1


# Methods and Functions (KEYWORD2)
add	KEYWORD2
reset	KEYWORD2
count	KEYWORD2

getAverage	KEYWORD2
getTotalLength	KEYWORD2
getAverageLength	KEYWORD2

setType	KEYWORD2

lastError	KEYWORD2


# Constants (LITERAL1)
AVERAGE_ANGLE_LIB_VERSION	LITERAL1

DEGREES	LITERAL1
RADIANS	LITERAL1
GRADIANS	LITERAL1

AVERAGE_ANGLE_OK	LITERAL1
AVERAGE_ANGLE_OVERFLOW	LITERAL1
AVERAGE_ANGLE_SINGULARITY	LITERAL1

